+-------------------+
|                   |
|   XXXXXXXXXXXXG   |
|    SXXXXXXXXXX    |
|     XXXXXXXXX     |
|      XXXXXXX      |
|       XXXXX       |
|        XXX        |
|         X         |
|                   |
+-------------------+
